R 640 480 
SO ./pics/redbrick.xpm 
WE ./pics/purplestone.xpm
EA ./pics/greystone.xpm
NO ./pics/eagle.xpm
S ./pics/barrel.xpm
F 200,100,0
C 225,30,0
1111111111111111
100000001111111
100000000000N011
1200000000000001
1111111111111111
1111111111111111
100000001111111
11111111111111
