NO ./pics/colorstone.xpm
R     100000000000   2000
SO ./textures/redbrick.xpm
WE ./textures/purplestone.xpm
EA ./textures/greystone.xpm
   
C 0  ,5,200
F 0,     00, 0 

S ./textures/barrel.xpm

   111111111111111111
  111111110002000001
   102000000000111111
    11111111100E000001
            1000200001
            1200200001
           11000000001
          1111111111111

