11111111111
1E00PC0C001
10110001101
10101001111
1111111111111
