11111111111
1E000C0C001
10110001101
10101001111
11111111111
