11111111111
0E00PC0C001
10110001101
10101001111
11111111111
