R 600 600
NO ./pics/eagle.xpm
SO ./pics/redbrick.xpm
WE ./pics/purplestone.xpm
EA ./pics/greystone.xpm
S ./pics/man.xpm
F 220,100,0
C 225,30,0

1111111111111111111111111111111111111111111111111111111111111111111111111111111111111111111111111111
1002000000000000002020000200020000020000000000000000000000002002000000000000202000000202002002020001
1000000002000000002000000000020220000000000000000002000002200000000000200020000000000000000000000001
1000000000200200000000000000200000022000000002000002000002000002000000020002000000000000000000000001
1000000000000000002200200000000000020000000000000000000000000000200000000002020002000000000000200001
1000002000000200000000002200020002020000000000000000000200000000020002000000000000000000000000000001
1002000200000000000002020000000020000000000000200000020000000000000000200000000020000020200020000001
1000000200000000000002000000000000000000000020000000000000000000000020000220000002000000000000000201
1200000200200000200000000020220200000000000000000000020200000000000000002000000002000002000000000001
1000000000020000000000000002000000000000000000000000002000000020000000000000000000000000000000000001
1002000002000000000000200000002000000000000000000000000000000200000002000002002000000000002000020001
1000200000000200000000000000000000002002002020022000000000N00000000000002000000020000000000000000001
1000000000020000200220000200000000002000000000000000000000000000000000000000000222020000000000002001
1000000000000000000002000000000000000000000020200202000000020200022000000000020000000000000200000001
1020000000000200020200200200000000000200000200000202200002000000002000000200002000200000000000000001
1000000000000000000000000000000000200002000000220000000000000000000000000000000000000000000000000001
1000000000000200000000000220000000000000000000200020000000000000020202200000000000000000000020000001
1020000020000000000020000000020000000000000200000000000200000000000000000000000000000000002000000001
1000002000002000020000000000000000000000000000200000000000000000000200000000000000000220000000000001
1020000000000000200200000000000000000000000000000000002200000200000002002200000000000000000220000001
1000000000202000000000002002000000000000000200002000000020000200200000000000000000200000200000000001
1000000002200000000020000000000002200000200220000000020000000000000002000000000020000000002000022001
1000000200000000000200000000220000200020000000000000002000000000000000000000020000000000000000000001
1020000020000200020000000000000000000020000000000002000000000000000000000020220000000000000000000001
1000000000000002000200000002002200000020000000022000000000000002020000000000200000020020000000000001
1200200000000000000000000000000200002000000000002000000000020000002000000200020000022000000200000201
1000000000020000020000000000000000000000220000000000000000000000000000002000000020000200000000000001
1020000000200002000200000002000020000200000200000000002002000020000000000000000000020000000000000021
1000020000020000002200000000000000002200000000000200000000002000000000020000000000000020000020000001
1002200002000200000000000002000000200000000000200002000002000000200200002020000002200000000002200001
1000000000000000200000000000000000002000000000000000000000200000000020000000000000200202000000000001
1000000002000000000220020000000000000000020000000000000220000200000000000002000000220000000000000001
1000020000000002000000002000000000000002000000000002000000022000000000000000000022000000000000000001
1200000000020000200000000020000000200000000020002200000000000000000000000000000000000000002000000021
1000002000000000000020000000000000000000002000000220200000000000000020000000000000000002000000002001
1222000000022000000000220000002000200020020000000000020000020000200000000000020000000000000000020001
1000000000000020000002000000000200000000000000020000000000000000000000000020000200022000000000000001
1002002000000000000000000000022000200000000000000000000000000002000000002000000000000000000020002001
1002000000000020000000000200000200200200000000000000000002000200000000000000000200000000200000020001
1000000000000002200000000000200000000000000000000020000002200000000020002000200000020000002200002201
1020000000000000000000020020000000020000000000000000200000000020000000000000000022000020000000000001
1111111111111111111111111111111111111111111111111111111111111111111111111111111111111111111111111111
