R 300 300
NO ./pics/eagle.xpm
SO ./pics/redbrick.xpm
WE ./pics/purplestone.xpm
EA ./pics/greystone.xpm
S ./pics/pillar.xpm
F 220,100,0
C 0,30,0

1111111111
1222222021
1222022221
1202222221
1222222221
1022222021
1220220021
1222222221
1222202221
1222200221
12222N2221
1222222001
1222222221
1222202221
1220022221
1202222221
1022222221
1222022221
1222022221
1111111111
