R 300 300
NO ./pics/mossy.xpm
SO ./pics/mossy.xpm
WE ./pics/mossy.xpm
EA ./pics/mossy.xpm

S ./pics/man.xpm
F 220,100,0
C 225,30,0

1111111111111111
1000000000000001
1110000002000001
111000000N000001
111011000000111
111000000000011
1111011111100011
11110011111100011
1111101111100011
1111000111100011
11111100011100011
1111111100100011
11111111000011
111111111100011
111111111102011
111111111100011
1111111111111111
