R 501 500
NO ./pics/eagle.xpm
SO ./pics/redbrick.xpm
WE ./pics/purplestone.xpm
EA ./pics/greystone.xpm
S ./pics/barrel.xpm



F 220,100,0
C 225,30,0


1111111111
1000000021
1000020001
1200220001
1000000001
1002000001
1000000201
1000000201
1000000021
1000000001
1000200001
1200000021
1000000021
1000002001
1000000201
12000N0001
1000000001
1000020001
1000000001
1002200001
1000000001
1000220001
1002000001
1000000001
1000000001
1000000001
1000000001
1000200001
1200000001
1111111111
