111111111111111111111111111111111111111111111111111111111111111111111111
111111111111111111111111111111111111111111111111111111111111111111111111
1E00PC0C0011111111111111111111111111111111111111111111111111111111111111
101100011011111111111111111111111111111111111111111111111111111111111111
101010011111111111111111111111111111111111111111111111111111111111111111
111111111111111111111111111111111111111111111111111111111111111111111111
