11111111111
1E00PC0C001
10110001101
10102001111
11111111111
