11111111111
1E00P000001
10110001101
10101001111
11111111111
